NO ./textures/wall.xpm
SO ./textures/wall_1.xpm
EA ./textures/wall_2.xpm
WE ./textures/wall_3.xpm

F 200,100,50
C 50,50,255


111111111111111111
1000N0000000000001
100100010000000001
111111110111111111
      100000000111
       10100000011
       11000000111
       11111111111