NO ./textures/wall_1.xpm
SO ./textures/wall_2.xpm
EA ./textures/eagle_1.xpm
WE ./textures/wall_3.xpm

F 200,100,50
C 50,50,255


        1111111111111111111111111     1111
        1000000000110000010000001     1001
        1000000000000000000000001     10N1
        1011000001110000010000001     1111
        1001000000000000010000011
111111111011000001110000010000001
100000000011000001110111111111111
11110111111111011100000010001
11110111111111011101010010001
11000000110101011100000010001
10000000000000001100000010001
10000000000000001101010010001
11000001110101011111011110001
11110111011101010101111010001
11111111111111111111111111111
